#########
#...~...#
#.o..#x#
#.#.o...#
#..@.~x.#
#########