#########
#.......#
#.o..#x#
#.#.o...#
#..@..x.#
#########