█████████████
█0..o...█..x█
█.o..████..██
█..█.....@..█
█████████████