#                    ##     
#####################..#### 
##..o..........o..........##
#..#.######.#########.....##
#..o.#..#.....##xxxx.......#
#..#o.o..o@$#.###xxx...##..#
#..o..#o.#.o..####xx#...xx##
#..#.o..o..#..#####x..##.x##
#..o.#.o#..o..######.##..###
##.........##.########....##
############################