#########
#.......#
#.o..#x#
#.#.o...#
#..@.~x.#
#########