█████████████
█.......█..x█
█.o..████..██
█.█.o█ █o...█
█..@.█████.██
█..█........█
█████████████