█████████████
█.......█..x█
█.o..████..██
█..█........█
█████████████